..IIIIIIIIIIIIIIIII..
.XIXIXIXIXIXIXIXIXIX.
IIIIIIIIIIIIIIIIIIIII
IXIXIXIXIXIXIXIXIXIXI
IIIIIIIIIIIIIIIIIIIII
.XIXIXIXIXIXIXIXIXIX.
..IIIIIIIIIIIIIIIII..